##########
#...x....#
##..##...#
##...#...#
####.#.#.#
#...#.#..#
##..#.#..#
##..#...##
#......o.#
##########
