##########
#..x.....#
#.......##
#........#
#...#.##.#
#........#
###...#..#
#.#..##..#
#.....o..#
##########
