##########
#x.......#
##.......#
##..#....#
#.#..#...#
#...##.#.#
#...####.#
#......#.#
#..o.....#
##########
