##########
#......x.#
#........#
#...#....#
#..#.....#
#......###
#..#....##
#...#.#..#
#...o....#
##########
